
EA textures/xpm/bluestone.xpm
NO textures/xpm/eagle.xpm
SO textures/xpm/colorstone.xpm
WE textures/xpm/purplestone.xpm

F 30, 30, 30
C 0,35,115

        11111111111
        10000000001
1111111110000000001
1000000000000000001111111111
1000000000000000000000000001
1000000000000000000000000001    1111
1000000000111111110000000001    1001
10000000001      10000000001    1111
10000001111      10000000001
1000000000111111110000000001
1000000000000000000000000001
1000000000000000000000000001
1111111100000000000011100001111111111
       111000000000010000W00010000001
       100000000000000000000010000001
1111111100000111111001110000000000001
10000000000001 1000001 10000010000001
11111111111111 1111111 11111111111111